varech	wawèt
verrederhum	ponch,pétépyé,sèk,tisèk,foliba,maténonm
véritable	véritab
versatile	palayi-palaya
vie	lavi
vice	vis
vicieux	visyé,mako
vis	vis
voiture	loto
voler	vôlè
vorace	agoulou,agoulou-gran-fal,saf
voracité	agouloutri
vouloir	lé
voyou	vakabon
vrai	vréabeille	mouchanmyèl
accelérer	akséléré,pilé
accélérateur	aksélératè
acheter	genyen,achté
acteur	aktè
action	aksyon
actionnaire	aksyonnè
actrice	aktris
admettre	admèt
admirable	admirab
admirateur	admiratè
admirer	admiré
afè	affaire
africain	afritjen
afrique	lafrik
agréable	agréyab
agriculture	agrikilti;lagrikilti
agir	aji
aide	pal
aiguille	zédjui
allumer	limen
allumette	zalimèt
ami	zanmi,konpè,padna
amie	makôkôt,zanmi
amitié	lanmityé
ampoule	zanpoul
anémone	koukoun-lanmè
anguille	zandji
anneau	zanno
appât	lak
arbre	piébwa
arête(demeuble,demuretc.)	kan
assurance	lasirans,asirans
assurer	asiré
assureur	asirè
atelier	latilyé,atilyé
attacher	taché,maré
attacherlemouchoirdetête	kalanndémadras-la
attacheusedecanneàsucre	marez
attitude	latitid,atitid
aujourd'hui	jòdi
avortement	avotman
avorter	avòté
avorton	tigrenn-chienbarbe	bab
bague	bag
blaguer	pwanlablag;badojé
bille	mab,agat,kristal,kannik
blagueur	badjolè
bal	bal
balai	balé
balancer	balansé
baleine	balenn
balle	boul
ballon	boule
balourd	lousmamé
balourdise	mannièlousmamé
banc	ban
bambou	banbou
banquet	granpenteng
beau	bèl
beauté	belté,laboté,boté
bête(animal)	bet
bête	bèt,kouyon,tèbè,ababa,apoda,atjoupanm
beurre	bè
blanc	blan(couleur);bétjé-fwans(race)
blanchir	blanchi;métélablanni(linge)
bleu	blé
boire	bwè;bwésonnen
boite	bwèt
boiteàordures	bwètzôdi,bonmzôdi
boiteenmétal	bonm
bosquet	razyé
bosse	bôs
bossu	bosi,bôsko
bouche	bouch,djôl,djèl
bouchbée	èstébékwé
bouger	brennen,rimyen,rimen
bougie	bouji,balenn,blan-balenn
bourdon	vonvon
bourse	bous
boudonner	vonvonner
buisson	razyé
buste	bis
but	bi
buveur	tafyatè,wonmyé,bivècache-cache	zwèlséré
canard 	kanna.
cancer	kansè
caresse	karès,miyonnaj
caresser	karésé,miyonnen
cauchemar	vyérèv
cercueil	sèrtjèz,sèrkèy
chandelle	chandèl
chandelier	chandelier
changer	chanjé,mofwazé
chance	chance
chanceux	chansé
chaleur	chalè
champion	mapipi
chanter	chanté
chanteur	chantè
chat	chat
chaude-pisse	chôlpis
chaudière	chodyè
chauffer	chofé
chauffeur	chofè
chauve	youl,tèt-kokosèk
chercher	chèché,chaché
chéri	doudou
chien	chyen
chomage	chomaj
chomeur	chomè
cigare	siga
cigarette	sigarèt
cinéma	siléma,sinéma
clitoris	landjèt
cocufiage	kout-kôn
cocufier	kônen
coincer 	kwennsé.
colline	môn
colonnevertébrale	larèldo
combat	konba,goumen,ladjè
combattre	konbat,bat,goumen,fè/lévéladjè
compte	kont
compter	konté
concert	konsè
concombre	konkonm
confondre	konfonn
confiture	konfiti
confusion	bankoulélé,lélékou,manjékochon
connaître	konnèt
construction	konstriksyon
construire	konstwi
contradiction	kontradiksyon,dékontwolaj
contrebande	kontribann
contrebandier	kontribandyé
contredire	kontridi,dékontwolé
contremaître	koumandè(enagriculture);kontrimèt
convaincre	konvenk
corps	kô
costaud	kôsto,malaba
coupe	koup(objet);lakoup(delacanne,delabananeetc.)
coupeurdecanne	koupèkann
courtisane	matadô
coutiser	zayé
cul	bonda,dèryè,tjou
culture	kilti
cultivateur	kiltivatè
cultiver	kiltivé
cyclône	siklôndangereux	danjéré
danser	dansé
dansè	danseur
dé	dé
découvrir	dékouvè
dentiste	dantis
déborder	débòdé ;débowné
débrouillard	débouya
débrouiller(se)	débouyékò'w
défendre	défendre
déjà	ja,za
démangeaison	gratel,lagratel
demi	dimi
demi-heure	dimi-è
demi-mondaine	matadò
démolir	dékalé,dépotjolé
démolition	dékalaj,dépotjolaj
derrière	dèyè
derrière(cul)	deriè,tjou,bonda
deux	dé
devenir	vini
devenir(le)	divini
devin	séyansié,gadè-d-zafè
deviner	divinen;fèséyans
devoir(un)	divwè
devoir	dwet,dwé
devoir(del'argent)	dwé
directeur	dirèktè,mèt-a-manyôk
direction	dirèksyon
divinasyon	séyans
doigt	dwèt
dormir	dômi
dos	do
doux	dous
drague	zay
dragueur	zayèébrécher	bréché
écaille	zékay
éclair	zéklè
écorcher	kôché,griji
écorchure	kôchaj,griji,grijisman
écraser	krazé
écrevisse	kribich,zabitan
écrire	ékri,matjé
écrivain	écrivain,matjè
électeur	élèktè
élection	élèksyon
élève	zélèv
élever	élivé
éleveurdecoqsdecombat	pitè
embêter	tenmbolizé,tèrbolizé
embrouillamini	bankoulélé,lélékou,manjékochon
émietter	chiktayé
encre	lank
encrier	lankriyé
endurer	pijé,pwanfè
enfant	yich,timanmay,manmay
enfanter	fèyich,fètimanmay
enfuir(s')	wondi,mèch,pwanlavôl,fèlafimen
enregistrer 	anrijistré
ensorceler	tjenbwazé,monté,pyayé
entraille	zantray,bway
épicerie	boutik,débi-d-laréji
épingle	zépeng
éplucher	pliché
épluchure	plichi
ergot	zègo
espiègle	katjopin
essayer	séyé,éséyé
etcoetera	kisasayésa
éternité 	létènité,tannité
étidiant	étidyan
étoile	zétwèl
étrenne	zétrenn
étude	étid,létid
étudier	étidyé
exciter(s')	fèchalèfard	fa
fâcher	faché
famille	fanmi
facile	fasil,flouz
falloir	fôk,fodré,fo
fantôme	zonbi
farine(defroment)	farin-fwans
fascicule	fasikil
fatiguer	fatidjé,renté,las,avanni
faucille	fosi
faute	fôt
fauteuil	fotèy
fenêtre	lafinèt,finèt
fier-à-bras	majô
fille	fi
femme	fanm
fendre	fann
feindre	fèwôl,fèlasanblan
feinte	flent,fent
feinter	flennté,fenté
fellation	sous
femelle	fimèl
fesse	fès;ponm-fès
fête	lafèt,fèt,banbôch,penteng
feuille	fèy
filiforme	mègzoklèt
finir	fini
flatter	flaté,sousé
flatteur	flatè,sousè,sousèkè
force	lafôs,fôs
fort	fô
fou(folle)	fou,dèkdèk,tôktôk
fouiller	foué,friyé
foutre	fouté
frêle 	fiankan,flègèdè,flègèdek
froid(le)	frédi
froid(avoir)	frèt
frontière	lalinman
fruit-à-pain	fouyapen,friyapen
fusil	fizi
fusiller	fisillergai	djé
gaieté	djété
gallodrome	pit
galoper	galoper
galopin	mamoukatji
gamelle	ganmèl
garçon	gason
garde	gad
garnir	garni
gâteau	gato
georges	jôj
geste	jès
gifle	kalôt
giflesurlesdeuxjoues	palaviré
giron	madafa
goût	gou
goûter	gouté
goûter(un)	katrè
grec	grèk
grèce	lagrès,grès
graisse	lagrès,grès
gratter	graté
grève	lagrèv,grèv
gréviste	grévis
grossier	gwosomodohameçon	zen
hardi	hadi,radi
haut	wo
hauteur	wotè
hindouisme	bondyé-kouli,mayémenn
hisser	palantjé
hiver	livèincube	dôwlis
infirme	enpyôk,enfim
innocent	inosan
instituteur	enstititè
inutile	initil
inventaire 	lenvantèjaloux	jalou
jalousie	jalouzi
jambon	janbon
jardin	jaden
jare	ja
jaune	jôn
jeu	jé
jeudi	jédi
jeune	jenn
jeunesse	jénès
Jésus-christ	Jézikri
jour	jou
journée	lajounen,jounen
judo	jido
judoka	jidoka
jujube	jijib
juge	jij
juger	jijé
juridiction	jiridiksyon
juridique	jiridique
juriste	jiriskaki	kaki
kilo	tjilo
kilomètre	tjilomètlâche	kapon,lach
laid	lèd
laideur	lédè
laideron	tètzoto
lapin	lapen
large	laj
largeur	lajè
lecteur	lèktè
lèsbienne	zanmiyèz
lettre	lèt
libellule	marisosé,dimwazèl
limon	lali
lire	li
lit	kabann
litàcolonnes	zizimtolé
locataire	lokatè
louche(œil) 	loli,zyé-loli
louer	lwé
loup	lou
lourd	lou
lymphatique	môlpi

maigre	mèg
maire	mè;li-mè
maître	mèt
maîtresse	métrès
maîtresse-femme	malfanm
marchande	machann
marchander	marchandé
marché	maché,mawché
marcher	maché
machine	machin
machoire	machwè
malad	malad
maladie	maladi
malfaiteur	malfétè
malheur	malè
malheureux	maléré
malin	malen
maman	manman
manger	manjé
mangeur	manjè
mangouste 	mangous,manglous
marbre	mab
mare	ma
marque	mak
massacre	masak,dépotjilaj,dérayaj
massacrer	masakré,dépotjolé,dérayé
maudire	modi
maudit	modi
mauvais	mové
mendiant	mandyannè
mendier	mandyanné
mensonge	mansonj,mantri,mantézon
menteur	mantè
mentir	manti
mesure	mizi
mesurer	miziré
miette	chiktay
militaire	militè
misérable	mirézab
misérabiliste	misérabilis
misère	lanmizè,misère
moeurs	mès
moiré	sousoun-klérant,sousoun-kléré
moquer	motjé
moqueur	motjè
monter	monté
morceau	môsô
mort	mounmô;mô
morue	lanmori
moteur	motè
mouchoir	mouchwè
mouchoirdetête	mouchwè-tèt,madras
moulin	moulen
mourir	mô
mouton	mouton
muscle	miks
musclé	misklé
myope 	koki,zyé-koki
mystère	mistènain	mamoukatji
naître	né,nèt
narine	zel-nen
nécessaire	nésésè
nécessité	nésésité
nègre	nèg,nèg-nwè
nénuphar	chapo-dlo
neveu	nivé
nez	nen
nièce	nyès,niyès
noce	nôs
noceur	banbochè,kranè,féta
noir	nwè
noirceur	nwèsè
nouveau	nouvo
noyer(se)	néyé
nuage	niyajobéïr	obéyi
occupation	otjipasyon
occuper(s')	otjipé
offrande	ofwann
offrir	ofè
ongle	zong
orange	zoranj,zowanj
ordure	zòdi
oreiller	zowyé
orteil	zotèy
ortolan	zòtolan
os	zo
ossature	zobray
ours	louspalmiste	palmis
panier	panyen,pannyé
panser	pansé
pantin	bélévan,bwabwa
pantouf	pantoufle
parapluie	parapli
pardon	padon
pardonner	padonnen
parent	paran
parler	palé
pasteur	pastè
patience	pasyans
patrimoine	matjoukann
pauvre	pôv
payer	péyé
payeur	péyè
peau	lapo
peindre	penn;pentiré
peigne	peny,penn
peigner	penyen
peintre	pent
peinture(bâtiment)	lapenti
peinture(art)	penti
pendant	pannan,pandan
penser	pansé
père	papa;pè
père(religieux)	pè,monpè
peser	pézé
pet	pété
pétarader	pétayé
péter	pété
peut-être	nè,mèyè,pétèt,pitèt
piège	zatrap
piéger	pwanadananzatrap
pilule	pilil
pinceau	penso
pincement	pichon
pincer	pichonnen
pipe(àtabac)	pipe
pipe(fellation)	sous
pisse-au-lit	pisannit
pisser	pisé
pleutre	kôkôdô
pleurésie	pirézi
poids	pwa
pois	pwa
porte	lapôt
poste	pôs;lapôs
pot	pôt
potdechambre	dobann,pôtchanm
pouce	pous,gwodwèt
poudre	lapoud
poul	poul
poulailler	kay-poul
poupée	pôpôt
poursuite	zwèlséré
pousser	pousé
pousser(grandir)	pousé,pwofité
pouvwè	pouvoir
prefet	préfé
préfecture	lapréfèkti,préfèkti
prendre	pran
préservatif	fokal,chapo
préservation	prézèvasyon
préserver	prézèvé
preuve	prèv
prévoir	prévwè
prison	lajôl,laprizon,prizon
promesse	pwonmès
promettre	ponmèt,pwonmèt
prostate	blad-pisa
prostituée	manawa,bôbô
prostituer(se)	fèmanawa
proue	wagaba
puce	pis
puisque	pis
punaise	pinez
punir	pini
punition	pinision
purée	piré
purger	pijé
pus	matiè,pi,lapostim,limèquart	ka
quartd'heure	kardè
querelle	tren,ladjè
quereller	chachétren,siré
querelleur	chach-tren,sirèraccourci	chimen-dékoupé
raccourcir	rakousi
race	ras
raciste	rasis
rapide	rapid
rapidité	balan
rare	ra
rat	rat
rater	mantjé
rebuffade	bok,bouf
recette 	riset
refroidir	frédi,rifrédi
refroidissement	frédisman
retard	rita
retardataire	ritardatè
retarder	ritadé
retour	viré,déviré,ritou
rêve	rèv
rêver	révé
rêveur	révè
rhum	wonm;tafia
rire	ri
risque	riks,risk
roi 	wa
rond	won
rue 	lari
ruelle	riyelsaler	salé
savoir	sa,sav,konnet
scélérat	séléra,chyen,chyenfè,isalôp
scélératesse	chyennri,salopri,salopté
sec	chès,sèk
sécher	séché
sécheresse	chesres,sechres
sein	tété
sel	sel
semer 	simen
sentier	tras
sentir	santi
série	séri,latilié,etsétéra
sérieux 	sérié,sériez
serrure	séri
seul	sel;yonn
sieste	bas-tet,kanm,lasies
soeur	sésé,sè
soir	swè,oswè
sommeil	sonmèy
sommeiller	dômi;fèankanm,fèanpôztèt
sorcellerie	tjenbwa
sorcier	tjenbwazè,manntò
souffle	souf
souffre	souf
souffrance	soufwans
soulagement	soulajman,wouspèl
soulager	soulajé,baanwouspèl
souffrir	soufè
soupe-au-lait	soupoulèt
sourd	soud
sucette	sisèt
sucer	sisé;fèansous
suer	swé
sud	li-sid,sid
supplication	siplikasyon,tanprisouplé
supplice	siplis
supplier	sipliyé,mandétanprisouplétacot	bradjak
tambour	tanbou
tambourinaire	tanbouyé
tazard	taza
téléphone	téléfôn
téléphoner	téléfônen
tenirtête	tèsté
testicule	grenn
théâtre	téyat
timbre	tenm
timid	timide
timidité	timidité
tort	tô
touiller	lélé
tranquille	trantjil
tranquillité	trantjilité
transformateur	transfômatè
transformation	transfômasyon,mofwaz
transformer	transfômé,mofwazé
transport	transpô
triste	tris
tristesse	tristès,latristès
trou	tou,twou
trouble	twoub
troubler	twoublé
tuer	tjwé
tuf	tifun 	yonn
urine	pisa
uriner	pisé,fèpipi
usine	lizin
usinier	izinyévarech	wawèt
verrederhum	ponch,pétépyé,sèk,tisèk,foliba,maténonm
véritable	véritab
versatile	palayi-palaya
vie	lavi
vice	vis
vicieux	visyé,mako
vis	vis
voiture	loto
voler	vôlè
vorace	agoulou,agoulou-gran-fal,saf
voracité	agouloutri
vouloir	lé
voyou	vakabon
vrai	vré